{
    "tile_size": 48,
    "width": 20,
    "height": 15,

    "legend": {
        "0": "floor",
        "1": "wall",
        "2": "key",
        "3": "exit"
    },

    "maze": [
        [1,1,1,1,1,1,1,1,1,1,1,1,1,1,1,1,1,1,1,1], 
        [1,0,2,0,0,1,0,0,0,0,1,0,0,0,2,0,0,0,0,1], 
        [1,0,0,0,0,1,0,0,0,0,0,0,0,0,0,0,0,0,0,1], 
        [1,1,1,0,1,1,1,0,1,1,1,1,1,0,1,1,1,0,1,1], 
        [1,0,0,0,0,1,0,0,0,0,1,0,0,0,0,0,0,0,2,1], 
        [1,0,0,0,0,1,0,2,0,0,1,0,0,0,0,0,0,0,0,1], 
        [1,1,1,0,1,1,1,0,1,1,1,1,1,0,1,1,1,0,1,1], 
        [1,0,0,0,0,1,0,0,0,0,1,0,0,0,0,0,0,0,0,1], 
        [1,0,0,0,0,0,0,0,0,0,1,0,0,0,0,0,0,0,0,1], 
        [1,1,1,0,1,1,1,0,1,1,1,1,1,0,1,1,1,0,1,1], 
        [1,0,0,0,0,1,0,0,0,0,1,0,2,0,0,0,0,0,0,1], 
        [1,0,0,0,0,1,0,0,0,0,1,0,0,0,0,0,0,0,0,1], 
        [1,1,1,1,1,1,1,1,1,0,1,1,1,1,1,0,1,1,1,1], 
        [1,0,0,0,0,0,0,0,0,0,0,0,0,0,0,0,0,0,0,1], 
        [1,1,1,1,1,1,1,1,1,3,1,1,1,1,1,1,1,1,1,1]
    ],

    "start": [1, 13]
}